NO ./path_to_the_north_texture
SO ./path_to_the_south_texture
WE ./path_to_the_west_texture
EA ./path_to_the_east_texture

F 110,100,0

C 115,10,0

111111111111111111111111
10000001N100000000000001
100000001000000000000001
100000000000000000000001
100000000000000000000001
111111111111111111111111
