NO ./path_to_the_north_texture
SO ./path_to_the_south_texture
WE ./path_to_the_west_texture
EA ./path_to_the_east_texture

F 110,100,0

C 115,10,0

1111111111111111111111111111111111111111111111
1000000101000000000000001111111111111111111111
10N000011100000000000000001111111111111
10000000000000000000000000000000000011
100000000000000000000000001111111111111111111111111111111
11111111111111111111111111111111111111111111111111
