NO ./texture/colorstone.xpm
SO ./texture/eagle.xpm
WE ./texture/greystone.xpm
EA ./texture/redbrick.xpm

F 25,255,0

C 255,255,255

11111
11001
1100111111111111111111111111111111111111111111
1000000101000000000000001111111111111111111111
100000011100000000000000001111111111111
100000000000N0000000000000000000000011
100000000000000000000000001111111111111111111111111111111
11111111111111111111111111111111111111111111111111
