NO ./path_to_the_north_texture
SO ./path_to_the_south_texture
WE ./path_to_the_west_texture
EA ./path_to_the_east_texture

F 110,100,0

C 115,10,0

111111111111111111111111
10000001010000000000000111111111111111
100000011100000000000100000000000000011111111111111111111111111111
10000000000000000000N0100000000000000000000000000011111111111111111111111111111111111111
100000000000000000000100000000000000000000000000000000000000000000000000000000000000000011111111111111111111111111111
111111111111111111111111111111111111111111111111111111111111111111111111111111111111111111
