NO ./path_to_the_north_texture
SO ./path_to_the_south_texture
WE ./path_to_the_west_texture
EA ./path_to_the_east_texture

F 110,100,0


C 115,10,0

11111111
10000001
1000N001
11111111
